        9        #
00000000500000000#
0               0#
00000000500000000#
        5        #
      00500      #
      0   0      #
    005000500    #
    0       0    #
  0000000000000  #
  0   0   0   0  #
50005000500050005#
0   0   0   0   0#
00000000000000000#
 111 222 333 444 #
 1 1 2 2 3 3 4 4 #